#######
#     #
#P    #
# XO  #
#  OX #
#######
