####################
#     O            #
#  #  #####        #
#  #     X  #      #
#  X   ##   #   OO #
# X #   #   #      #
#  X    #   ####   #
##  #X  # X  #     #
#   #    #   #   P #
#X       #   #######
#    ###           #
#OO  #             #
#    #             #
####################
